v	1	1	1	1	1	1	1	1	1	1	1	1	1	0	0
v	1	1	1	0	0	1	1	1	1	1	1	1	1	0	0
v	1	1	0	2	3	0	1	1	1	1	1	1	1	0	0
v	1	1	0	0	0	0	5	0	0	1	1	1	1	0	0
v	1	1	0	1	0	0	0	0	0	0	1	1	1	0	0
v	1	1	0	0	4	3	0	0	0	6	7	1	1	0	0
v	1	1	0	0	0	0	1	0	0	0	0	1	1	0	0
v	1	1	0	0	0	0	0	1	7	0	1	1	1	0	0
v	1	1	1	1	1	1	1	1	1	1	1	1	1	0	0
v	0	0	0	0	0	0	0	0	0	0	0	0	0	0	0
